2222222222
2000000002
2000003002
2000202002
2000000002
2002002002
2004000002
2000000002
2000000002
2222222222
