3222222222
2430400002
2000300002
2000000002
2000130042
2000000002
2000300002
2000400002
2000000002
2222222221
